11111111111
1P000C00001
11110000001
10000000001
10001110001
1C000000001
10000000001
10100000001
10100C11101
10111110111
10000000001
11111000001
1E000000001
11111111111
